NO ./textures/north.xpm
SO ./textures/south.xpm
WE ./textures/west.xpm
EA ./textures/east.xpm
    
F 23,5,0
C 82,154,255

        1111111111111111111111111
        1E00000000110000000000001
      1 1011000001110000000100001
        1001000000000000001010001
111111111011000001110000000100001
100000000011000001110111111111111
11110111111111011100000010001
11111111111111011111110111111
             101     101
11111111111111011111110111111
11110111111111011101010010001
11000000110101011100000010001
10000000000000001100000000001
10000000000000001101010010001
110000011101010111110111100111
11110111 1110101 101111010001
11111111 1111111 111111111111